69
18
51 0 0 0 0 0 0 0 0 0 0 0 0 0 0 0 0 0 0 0 0 0 0 0 0 0 0 0 0 0 0 0 0 0 0 0 0 0 0 0 0 0 0 0 0 0 0 0 0 0 0 0 0 0 0 0 0 0 0 0 0 0 0 0 0 0 0 0 50 
51 0 0 0 0 0 0 0 0 0 0 0 0 0 0 0 0 0 0 0 0 0 0 0 0 0 0 0 0 0 0 54 24 25 0 25 25 25 8 25 25 17 8 25 12 25 8 25 25 12 25 25 25 16 25 26 56 0 0 0 0 0 0 0 0 0 0 0 50 
51 55 56 0 32 0 0 32 0 0 32 0 0 32 0 0 32 0 0 0 0 0 0 0 0 0 0 0 0 0 32 52 55 55 0 55 55 55 55 55 55 55 55 55 55 55 55 55 55 55 55 55 55 55 55 55 58 0 0 0 0 0 0 0 0 0 32 32 50 
51 7 57 0 0 0 0 0 0 0 0 0 0 0 0 0 0 0 32 0 0 0 0 0 0 0 0 0 0 0 0 52 6 58 0 6 7 0 0 0 0 0 17 0 0 0 12 17 0 0 0 0 11 0 0 0 58 0 0 0 0 0 0 0 0 0 0 0 50 
51 0 0 37 9 9 9 9 9 9 9 9 9 38 0 0 0 0 0 0 0 0 0 0 0 0 0 0 32 0 0 52 0 0 0 57 0 0 54 55 55 55 55 55 55 55 7 6 55 55 55 55 55 55 56 0 58 0 0 0 0 0 0 0 32 0 0 0 50 
51 0 0 50 14 14 14 14 14 14 14 14 14 51 0 0 0 0 0 0 0 32 0 0 0 0 0 0 0 0 0 52 0 54 0 0 0 0 53 6 7 7 7 6 6 6 7 7 6 7 6 7 6 7 57 0 58 0 0 0 0 0 0 0 0 0 0 0 50 
51 0 0 0 0 0 0 0 0 0 0 0 0 0 0 0 0 0 0 0 0 0 0 0 0 32 0 0 0 0 0 52 0 7 0 0 60 0 0 0 0 0 0 0 0 0 0 0 0 0 0 0 0 0 0 0 58 0 0 0 0 0 0 0 0 0 0 0 50 
51 0 0 0 0 0 0 0 0 0 0 0 0 0 0 0 0 0 32 0 0 0 0 0 0 0 0 0 0 0 0 52 0 57 0 0 61 0 0 0 0 0 0 0 0 0 0 0 0 0 0 0 60 0 0 0 22 0 0 0 0 0 0 0 0 0 32 0 50 
51 0 0 0 0 0 0 0 0 0 0 0 0 0 0 0 0 0 0 0 0 0 0 0 0 0 0 0 0 0 0 52 0 0 0 60 61 0 0 0 0 0 0 0 0 0 0 0 0 0 0 0 61 0 0 0 22 0 0 0 0 0 0 32 0 0 0 0 50 
51 0 0 0 0 0 0 0 0 0 0 0 0 0 0 0 32 0 0 0 0 0 0 0 0 0 0 0 0 0 0 37 40 40 40 40 40 40 40 40 40 40 40 40 40 40 40 40 40 40 40 40 40 40 40 40 38 0 0 32 0 0 0 0 0 0 0 0 50 
51 0 0 0 0 0 0 0 0 0 0 0 0 0 0 0 0 0 0 0 0 0 0 0 0 0 0 0 0 0 0 0 0 0 0 0 0 0 0 0 0 0 0 0 0 0 0 0 0 0 0 0 0 0 0 0 0 0 0 0 0 0 0 0 0 0 0 0 50 
51 0 0 0 0 0 0 0 0 0 0 0 0 0 0 0 0 0 0 12 0 0 0 0 0 0 0 0 0 0 0 0 0 0 0 0 0 0 0 0 0 0 0 0 0 0 0 0 0 0 0 0 0 0 0 0 0 0 0 0 0 0 0 0 0 0 0 0 50 
51 0 0 0 0 0 0 0 0 0 0 0 0 37 38 0 0 0 37 38 0 0 0 0 0 0 0 0 0 0 0 0 0 0 0 0 0 0 0 0 0 0 0 0 0 0 0 0 0 0 0 0 0 0 0 0 0 0 0 0 0 0 0 0 0 0 0 0 50 
51 0 0 16 0 12 0 0 0 0 0 0 17 50 51 0 16 0 50 51 0 0 17 0 0 12 0 0 0 0 12 0 0 0 0 0 0 0 32 0 0 0 0 0 0 0 0 0 0 32 0 0 0 0 0 0 0 0 0 12 0 16 0 0 17 17 0 0 50 
37 39 39 39 39 39 15 15 15 40 40 39 39 39 39 39 39 39 39 39 39 39 39 39 39 39 15 15 15 40 38 0 0 0 32 0 0 0 45 46 46 46 46 46 46 46 46 46 46 47 0 0 0 32 0 0 0 37 39 39 40 39 40 39 39 39 40 39 40 
50 15 15 15 15 15 15 60 15 15 15 15 15 15 15 15 15 15 15 15 15 15 15 15 15 15 15 15 37 15 51 9 9 9 9 9 9 9 9 9 9 9 9 9 9 9 9 9 9 9 9 9 9 9 9 9 9 50 14 14 14 14 14 14 14 14 14 14 14 
50 15 15 15 15 15 15 61 15 15 15 15 15 60 15 15 15 15 15 15 15 15 15 60 15 15 15 37 51 15 51 10 10 10 10 10 10 10 10 10 10 10 10 10 10 10 10 10 10 10 10 10 10 10 10 10 10 50 14 14 14 14 14 14 14 14 14 14 14 
37 39 39 39 39 39 39 39 39 39 38 15 37 40 40 40 40 40 40 40 40 40 40 40 38 15 37 15 51 15 51 10 10 10 10 10 10 10 10 10 10 10 10 10 10 10 10 10 10 10 10 10 10 10 10 10 10 50 14 14 14 14 14 14 14 14 14 14 14 
