32
21
49 0 0 0 0 0 0 0 0 0 0 0 0 0 0 0 0 0 0 0 0 0 0 0 0 0 0 0 0 0 0 48 
49 0 0 0 0 0 0 0 0 0 0 0 0 0 0 0 0 0 0 0 0 0 0 0 0 0 0 0 0 0 0 48 
49 0 0 0 32 0 0 0 0 0 0 0 0 0 0 32 32 0 0 0 0 0 0 0 0 0 0 32 0 0 0 48 
49 62 0 0 0 0 0 0 0 0 0 0 0 0 0 0 0 0 0 0 0 0 0 0 0 0 0 0 0 0 62 48 
49 63 0 0 0 0 0 32 0 0 0 0 0 0 0 0 0 0 0 0 0 0 0 0 32 0 0 0 0 0 63 48 
49 63 0 0 0 0 0 0 0 0 0 0 32 0 0 0 0 0 0 32 0 0 0 0 0 0 0 0 0 0 63 48 
49 63 0 0 0 0 0 0 0 0 0 0 0 0 0 0 0 0 0 0 0 0 0 0 0 0 0 0 0 0 63 48 
49 63 0 0 0 32 0 0 0 0 0 0 0 0 0 0 0 0 0 0 0 0 0 0 0 0 32 0 0 0 63 48 
49 63 0 0 0 0 0 0 0 42 44 0 0 0 0 32 32 0 0 0 0 42 44 0 0 0 0 0 0 0 63 48 
49 63 0 0 0 0 0 0 0 15 49 0 0 0 0 0 0 0 0 0 0 48 15 0 0 0 0 0 0 0 63 48 
49 42 43 44 0 0 0 0 62 15 15 62 0 0 0 0 0 0 0 0 62 15 15 62 0 0 0 0 42 43 44 48 
49 15 15 49 62 0 0 0 63 15 15 15 62 0 0 0 0 0 0 62 15 15 15 63 0 0 0 62 48 15 15 48 
49 15 15 49 63 0 0 0 63 62 15 15 49 0 0 0 0 0 0 48 15 15 62 63 0 0 0 63 48 15 15 48 
49 15 15 15 15 0 0 0 63 15 15 15 15 0 0 0 0 0 0 15 15 15 15 63 0 0 0 15 15 15 15 48 
49 15 43 43 43 43 43 43 43 43 43 43 43 43 15 15 15 15 43 43 43 43 43 43 43 43 43 43 43 43 15 48 
49 15 15 15 15 15 15 15 15 15 15 15 15 15 15 15 15 15 15 15 15 15 15 15 15 15 15 15 15 15 15 48 
49 32 15 15 15 15 15 15 15 15 15 15 15 15 15 32 32 15 15 15 15 15 15 15 15 15 15 15 15 15 32 48 
49 15 15 15 15 15 15 15 15 15 15 15 15 15 32 15 15 32 15 15 15 15 15 15 15 15 15 15 15 15 15 48 
49 15 15 15 15 15 15 15 15 15 15 15 15 15 15 15 15 15 15 15 15 15 15 15 15 15 15 15 15 15 15 48 
49 42 43 44 15 32 15 15 15 32 15 15 15 32 42 43 43 44 32 15 15 15 32 15 15 15 32 15 42 43 44 48 
49 48 15 49 9 9 9 9 9 9 9 9 9 9 9 9 9 9 9 9 9 9 9 9 9 9 9 9 48 15 15 48 
